	[
		{
			"title": "All",
			"src":
			[
				"1.png",
				"2.png",
				"3.png",
				"4.png",
				"5.png",
				"6.png",
				"7.png",
				"8.png",
				"9.png",
				"1.png",
				"2.png",
				"3.png",
				"4.png",
				"1.png",
				"2.png",
				"3.png",
				"4.png",
				"5.png",
				"6.png",
				"7.png"
			]
		},
		{
			"title" : "Branding",
			"src":[
				"3.png",
				"4.png",
				"3.png",
				"4.png",
				"3.png",
				"4.png",
				"3.png",
				"4.png",
				"3.png",
				"4.png",
				"3.png",
				"4.png",
				"3.png",
				"4.png"
			]
		},
		{
			"title": "Web",
			"src": [
				"1.png",
				"2.png",
				"1.png",
				"2.png",
				"1.png",
				"2.png",
				"1.png",
				"2.png",
				"1.png",
				"2.png",
				"1.png",
				"2.png",
				"1.png",
				"2.png"
			]
		},
		{
			"title": "Logo Design",
			"src": [
				"5.png",
				"6.png",
				"5.png",
				"6.png",
				"5.png",
				"6.png",
				"5.png",
				"6.png",
				"5.png",
				"6.png",
				"5.png",
				"6.png",
				"5.png",
				"6.png",
				"5.png",
				"6.png"
			]
		},
		{
		"title": "Photography",
			"src":
			[
				"7.png",
				"8.png",
				"9.png",
				"7.png",
				"8.png",
				"9.png",
				"7.png",
				"8.png",
				"9.png",
				"7.png",
				"8.png",
				"9.png",
				"7.png",
				"8.png",
				"9.png",
				"7.png",
				"8.png",
				"9.png"
			]
		}
	]
